11111
10C11
10001
1PE01
11111
