111111111111111111111111111111111111111
1P0000000000000000000000000000000000001
100101010101000000000000000010101010101
1000000000000000000000000000000000000C1
100101010101000000000000000010101010101
100000000000000000000000000000000000001
100101010101000000000000000010101010101
100000000000000000101000000000000000001
100101010101000001101100000010101010101
100000000000000111000111000000000000001
1001010101010001000E00010000101010101C1
100000000000000111000111000000000000001
100101010101000001101100000010101010101
100000000000000000111000000000000000001
111111111111000000000000000011111111111
111111111111111111111111111111111111111
